result path
 Mouse Property 
- energy : 4692 / mana - 9.1 / Current Steps - 191 / Remaining energy - 4501 / Current Position - ( 45, 27 )
Maze Size 46*51
¡á¡¡¡á£¿£¿£¿£¿£¿£¿£¿£¿£¿£¿¡á¡á¡á£¿£¿£¿£¿£¿£¿£¿£¿£¿£¿£¿£¿£¿£¿£¿£¿£¿£¿£¿£¿£¿£¿£¿£¿£¿£¿£¿£¿£¿£¿
¡á¡¡¡¡¡á£¿£¿¡á¡á¡á¡¡¡á¡á¡á¡¡¡¡¡¡¡á£¿£¿£¿£¿£¿£¿£¿£¿£¿£¿£¿£¿£¿£¿£¿£¿£¿£¿£¿£¿£¿£¿£¿£¿¡á£¿£¿£¿£¿
£¿¡á¡¡¡á¡á¡á¡¡¡¡¡¡¡¡¡¡¡¡¡¡¡¡¡á¡¡¡á£¿£¿£¿£¿£¿£¿£¿£¿£¿¡¡¡á¡á¡á£¿£¿£¿£¿£¿£¿£¿¡á¡á¡á¡á¡¡¡á£¿£¿£¿
£¿¡á¡¡¡¡¡¡¡¡¡¡¡á¡á¡¡¡á¡á¡á¡á¡á¡¡¡á¡á¡á¡á£¿£¿£¿£¿£¿¡¡¡¡¡¡¡¡¡¡¡á¡á¡á¡á¡¡£¿¡á¡¡¡¡¡¡¡á¡¡¡á£¿£¿£¿
£¿£¿¡á¡á¡á¡á¡á£¿£¿£¿£¿£¿£¿£¿¡á¡¡¡¡¡¡¡¡¡¡¡á£¿£¿£¿£¿¡á¡¡¡á¡á¡¡¡á¡¡¡¡¡¡¡¡¡á¡á¡¡¡á¡¡¡á¡¡¡á¡á£¿£¿
£¿£¿£¿£¿£¿£¿£¿£¿£¿£¿£¿£¿£¿£¿£¿¡¡¡á¡á¡á¡¡¡á£¿£¿£¿£¿¡á¡¡¡á¡á¡¡¡á¡¡¡á¡á¡¡¡¡¡¡¡¡¡á¡¡¡á¡¡¡á¡¡¡á£¿
£¿£¿£¿£¿£¿£¿£¿£¿£¿£¿£¿£¿£¿£¿£¿£¿£¿¡á¡¡¡¡¡á¡á¡á¡á¡á¡á¡¡¡á¡á¡¡¡á¡¡¡á¡á¡¡¡á¡á¡¡¡á¡á¡á¡¡¡á¡¡¡á£¿
£¿£¿£¿£¿£¿£¿£¿£¿£¿£¿£¿£¿£¿£¿£¿£¿¡á¡¡¡¡¡á¡á¡¡¡¡¡¡¡¡¡¡¡¡¡á¡á¡¡¡á¡¡¡á¡á¡¡¡á¡á¡¡¡¡¡¡¡¡¡¡¡á¡¡¡á£¿
£¿£¿£¿£¿£¿£¿£¿£¿£¿£¿£¿£¿£¿£¿£¿£¿¡á¡¡¡á£¿¡á¡¡¡á¡á¡á¡á¡á£¿¡á¡¡¡¡¡¡¡á¡á¡¡¡á¡á¡¡¡á¡á¡á¡á¡á¡¡¡á£¿
£¿£¿£¿£¿£¿£¿£¿£¿£¿£¿£¿£¿£¿£¿£¿£¿¡á¡¡¡á¡á¡á¡¡¡á£¿£¿£¿£¿£¿£¿¡¡¡á¡¡¡á¡á¡¡¡á¡á¡¡¡¡¡á¡á¡á¡á¡¡¡á£¿
£¿£¿£¿£¿£¿£¿£¿£¿£¿£¿£¿£¿£¿£¿£¿£¿¡á¡¡¡¡¡¡¡¡¡¡¡á£¿£¿£¿£¿£¿£¿£¿£¿¡á£¿¡á¡¡¡á£¿¡á¡¡¡¡¡¡¡¡¡¡¡¡¡á£¿
£¿£¿£¿£¿£¿£¿£¿£¿£¿£¿£¿£¿£¿£¿£¿£¿£¿¡á¡á¡á¡á¡á£¿£¿£¿£¿£¿£¿£¿£¿£¿£¿£¿¡á¡¡¡á¡á¡á¡á¡á¡á¡á¡á¡¡¡á£¿
£¿£¿£¿£¿£¿£¿£¿£¿£¿£¿£¿£¿£¿£¿£¿£¿£¿£¿£¿£¿£¿£¿£¿£¿£¿£¿£¿£¿£¿£¿£¿£¿£¿¡á¡¡¡¡¡¡¡¡¡¡¡¡¡¡¡¡¡á¡¡¡á£¿
£¿£¿£¿£¿£¿£¿£¿£¿£¿£¿£¿£¿£¿£¿£¿£¿£¿£¿£¿£¿£¿£¿£¿£¿£¿£¿£¿£¿£¿£¿£¿£¿£¿£¿¡á¡á¡á¡á¡á¡á¡á¡¡¡á¡á£¿£¿
£¿£¿£¿£¿£¿£¿£¿£¿£¿£¿£¿£¿£¿£¿£¿£¿£¿£¿£¿£¿£¿£¿£¿£¿£¿£¿£¿£¿£¿£¿£¿£¿£¿¡á¡¡¡¡¡¡¡¡¡¡¡¡¡¡¡¡¡á£¿£¿£¿
£¿£¿£¿£¿£¿£¿£¿£¿£¿£¿£¿£¿£¿£¿£¿£¿£¿£¿£¿£¿£¿£¿£¿£¿£¿£¿£¿£¿£¿£¿£¿£¿£¿¡á¡¡¡á¡á¡á¡á¡á¡á¡á£¿£¿£¿£¿
£¿£¿£¿£¿£¿£¿£¿£¿£¿£¿£¿£¿£¿£¿£¿£¿£¿£¿£¿£¿£¿£¿£¿£¿£¿£¿£¿£¿£¿£¿£¿£¿£¿¡á¡¡¡¡¡¡¡¡¡¡¡¡¡¡¡¡¡á£¿£¿£¿
£¿£¿£¿£¿£¿£¿£¿£¿£¿£¿£¿£¿£¿£¿£¿£¿£¿£¿£¿£¿£¿£¿£¿£¿£¿£¿£¿£¿£¿£¿£¿£¿£¿£¿¡á¡á¡á¡á¡á¡á¡á¡¡¡á£¿£¿£¿
£¿£¿£¿£¿£¿£¿£¿£¿£¿£¿£¿£¿£¿£¿£¿£¿£¿£¿£¿£¿£¿£¿£¿£¿£¿£¿£¿£¿£¿£¿£¿£¿£¿¡á¡¡¡¡¡¡¡¡¡¡¡¡¡¡¡¡¡á£¿£¿£¿
£¿£¿£¿£¿£¿£¿£¿£¿£¿£¿£¿£¿£¿£¿£¿£¿£¿£¿£¿£¿£¿£¿£¿£¿£¿£¿£¿£¿£¿£¿£¿£¿£¿¡á¡¡¡á¡á¡á¡á¡á¡á¡á£¿£¿£¿£¿
£¿£¿£¿£¿£¿£¿£¿£¿£¿£¿£¿£¿£¿£¿£¿£¿£¿£¿£¿£¿£¿£¿£¿£¿£¿£¿£¿£¿£¿£¿£¿£¿£¿¡á¡¡¡¡¡¡¡¡¡¡¡¡¡¡¡¡¡á£¿£¿£¿
£¿£¿£¿£¿£¿£¿£¿£¿£¿£¿£¿£¿£¿£¿£¿£¿£¿£¿£¿£¿£¿£¿£¿£¿£¿£¿£¿£¿£¿£¿£¿£¿£¿£¿¡á¡á¡á¡á¡á¡á¡á¡¡¡á¡¡¡á£¿
£¿£¿£¿£¿£¿£¿£¿£¿£¿£¿£¿£¿£¿£¿£¿£¿£¿£¿£¿£¿£¿£¿£¿£¿£¿£¿£¿£¿£¿£¿£¿£¿£¿£¿£¿£¿£¿£¿£¿£¿¡¡¡¡¡¡¡¡¡¡¡á
£¿£¿£¿£¿£¿£¿£¿£¿£¿£¿£¿£¿£¿£¿£¿£¿£¿£¿£¿£¿£¿£¿£¿£¿£¿£¿£¿£¿£¿£¿£¿£¿£¿£¿£¿£¿£¿£¿£¿£¿£¿¡á¡á¡¡¡á£¿
£¿£¿£¿£¿£¿£¿£¿£¿£¿£¿£¿£¿£¿£¿£¿£¿£¿£¿£¿£¿£¿£¿£¿£¿£¿£¿£¿£¿£¿£¿£¿£¿£¿£¿£¿£¿£¿£¿£¿£¿£¿£¿¡á¡¡¡á£¿
£¿£¿£¿£¿£¿£¿£¿£¿£¿£¿£¿£¿£¿£¿£¿£¿£¿£¿£¿£¿£¿£¿£¿£¿£¿£¿£¿£¿£¿£¿£¿£¿£¿£¿£¿£¿£¿£¿£¿£¿£¿£¿¡á¡¡¡á£¿
£¿£¿£¿£¿£¿£¿£¿£¿£¿£¿£¿£¿£¿£¿£¿£¿£¿£¿£¿£¿£¿£¿£¿£¿£¿£¿£¿£¿£¿£¿£¿£¿£¿£¿£¿£¿£¿£¿£¿£¿£¿£¿¡á¡¡¡á¡á
£¿£¿£¿£¿£¿£¿£¿£¿£¿£¿£¿£¿£¿£¿£¿£¿£¿£¿£¿£¿£¿£¿£¿£¿£¿£¿£¿£¿£¿£¿£¿£¿£¿£¿£¿£¿£¿£¿£¿£¿£¿£¿¡á¡¡¡¡¨Ù
£¿£¿£¿£¿£¿£¿£¿£¿£¿£¿£¿£¿£¿£¿£¿£¿£¿£¿£¿£¿£¿£¿£¿£¿£¿£¿£¿£¿£¿£¿£¿£¿£¿£¿£¿£¿£¿£¿£¿£¿£¿£¿£¿¡á¡á¡á
£¿£¿£¿£¿£¿£¿£¿£¿£¿£¿£¿£¿£¿£¿£¿£¿£¿£¿£¿£¿£¿£¿£¿£¿£¿£¿£¿£¿£¿£¿£¿£¿£¿£¿£¿£¿£¿£¿£¿£¿£¿£¿£¿£¿£¿£¿
£¿£¿£¿£¿£¿£¿£¿£¿£¿£¿£¿£¿£¿£¿£¿£¿£¿£¿£¿£¿£¿£¿£¿£¿£¿£¿£¿£¿£¿£¿£¿£¿£¿£¿£¿£¿£¿£¿£¿£¿£¿£¿£¿£¿£¿£¿
£¿£¿£¿£¿£¿£¿£¿£¿£¿£¿£¿£¿£¿£¿£¿£¿£¿£¿£¿£¿£¿£¿£¿£¿£¿£¿£¿£¿£¿£¿£¿£¿£¿£¿£¿£¿£¿£¿£¿£¿£¿£¿£¿£¿£¿£¿
£¿£¿£¿£¿£¿£¿£¿£¿£¿£¿£¿£¿£¿£¿£¿£¿£¿£¿£¿£¿£¿£¿£¿£¿£¿£¿£¿£¿£¿£¿£¿£¿£¿£¿£¿£¿£¿£¿£¿£¿£¿£¿£¿£¿£¿£¿
£¿£¿£¿£¿£¿£¿£¿£¿£¿£¿£¿£¿£¿£¿£¿£¿£¿£¿£¿£¿£¿£¿£¿£¿£¿£¿£¿£¿£¿£¿£¿£¿£¿£¿£¿£¿£¿£¿£¿£¿£¿£¿£¿£¿£¿£¿
£¿£¿£¿£¿£¿£¿£¿£¿£¿£¿£¿£¿£¿£¿£¿£¿£¿£¿£¿£¿£¿£¿£¿£¿£¿£¿£¿£¿£¿£¿£¿£¿£¿£¿£¿£¿£¿£¿£¿£¿£¿£¿£¿£¿£¿£¿
£¿£¿£¿£¿£¿£¿£¿£¿£¿£¿£¿£¿£¿£¿£¿£¿£¿£¿£¿£¿£¿£¿£¿£¿£¿£¿£¿£¿£¿£¿£¿£¿£¿£¿£¿£¿£¿£¿£¿£¿£¿£¿£¿£¿£¿£¿
£¿£¿£¿£¿£¿£¿£¿£¿£¿£¿£¿£¿£¿£¿£¿£¿£¿£¿£¿£¿£¿£¿£¿£¿£¿£¿£¿£¿£¿£¿£¿£¿£¿£¿£¿£¿£¿£¿£¿£¿£¿£¿£¿£¿£¿£¿
£¿£¿£¿£¿£¿£¿£¿£¿£¿£¿£¿£¿£¿£¿£¿£¿£¿£¿£¿£¿£¿£¿£¿£¿£¿£¿£¿£¿£¿£¿£¿£¿£¿£¿£¿£¿£¿£¿£¿£¿£¿£¿£¿£¿£¿£¿
£¿£¿£¿£¿£¿£¿£¿£¿£¿£¿£¿£¿£¿£¿£¿£¿£¿£¿£¿£¿£¿£¿£¿£¿£¿£¿£¿£¿£¿£¿£¿£¿£¿£¿£¿£¿£¿£¿£¿£¿£¿£¿£¿£¿£¿£¿
£¿£¿£¿£¿£¿£¿£¿£¿£¿£¿£¿£¿£¿£¿£¿£¿£¿£¿£¿£¿£¿£¿£¿£¿£¿£¿£¿£¿£¿£¿£¿£¿£¿£¿£¿£¿£¿£¿£¿£¿£¿£¿£¿£¿£¿£¿
£¿£¿£¿£¿£¿£¿£¿£¿£¿£¿£¿£¿£¿£¿£¿£¿£¿£¿£¿£¿£¿£¿£¿£¿£¿£¿£¿£¿£¿£¿£¿£¿£¿£¿£¿£¿£¿£¿£¿£¿£¿£¿£¿£¿£¿£¿
£¿£¿£¿£¿£¿£¿£¿£¿£¿£¿£¿£¿£¿£¿£¿£¿£¿£¿£¿£¿£¿£¿£¿£¿£¿£¿£¿£¿£¿£¿£¿£¿£¿£¿£¿£¿£¿£¿£¿£¿£¿£¿£¿£¿£¿£¿
£¿£¿£¿£¿£¿£¿£¿£¿£¿£¿£¿£¿£¿£¿£¿£¿£¿£¿£¿£¿£¿£¿£¿£¿£¿£¿£¿£¿£¿£¿£¿£¿£¿£¿£¿£¿£¿£¿£¿£¿£¿£¿£¿£¿£¿£¿
£¿£¿£¿£¿£¿£¿£¿£¿£¿£¿£¿£¿£¿£¿£¿£¿£¿£¿£¿£¿£¿£¿£¿£¿£¿£¿£¿£¿£¿£¿£¿£¿£¿£¿£¿£¿£¿£¿£¿£¿£¿£¿£¿£¿£¿£¿
£¿£¿£¿£¿£¿£¿£¿£¿£¿£¿£¿£¿£¿£¿£¿£¿£¿£¿£¿£¿£¿£¿£¿£¿£¿£¿£¿£¿£¿£¿£¿£¿£¿£¿£¿£¿£¿£¿£¿£¿£¿£¿£¿£¿£¿£¿
£¿£¿£¿£¿£¿£¿£¿£¿£¿£¿£¿£¿£¿£¿£¿£¿£¿£¿£¿£¿£¿£¿£¿£¿£¿£¿£¿£¿£¿£¿£¿£¿£¿£¿£¿£¿£¿£¿£¿£¿£¿£¿£¿£¿£¿£¿
£¿£¿£¿£¿£¿£¿£¿£¿£¿£¿£¿£¿£¿£¿£¿£¿£¿£¿£¿£¿£¿£¿£¿£¿£¿£¿£¿£¿£¿£¿£¿£¿£¿£¿£¿£¿£¿£¿£¿£¿£¿£¿£¿£¿£¿£¿
£¿£¿£¿£¿£¿£¿£¿£¿£¿£¿£¿£¿£¿£¿£¿£¿£¿£¿£¿£¿£¿£¿£¿£¿£¿£¿£¿£¿£¿£¿£¿£¿£¿£¿£¿£¿£¿£¿£¿£¿£¿£¿£¿£¿£¿£¿
£¿£¿£¿£¿£¿£¿£¿£¿£¿£¿£¿£¿£¿£¿£¿£¿£¿£¿£¿£¿£¿£¿£¿£¿£¿£¿£¿£¿£¿£¿£¿£¿£¿£¿£¿£¿£¿£¿£¿£¿£¿£¿£¿£¿£¿£¿
£¿£¿£¿£¿£¿£¿£¿£¿£¿£¿£¿£¿£¿£¿£¿£¿£¿£¿£¿£¿£¿£¿£¿£¿£¿£¿£¿£¿£¿£¿£¿£¿£¿£¿£¿£¿£¿£¿£¿£¿£¿£¿£¿£¿£¿£¿
£¿£¿£¿£¿£¿£¿£¿£¿£¿£¿£¿£¿£¿£¿£¿£¿£¿£¿£¿£¿£¿£¿£¿£¿£¿£¿£¿£¿£¿£¿£¿£¿£¿£¿£¿£¿£¿£¿£¿£¿£¿£¿£¿£¿£¿£¿
Teleport ( 41, 2 ) to ( 37, 7 )
Teleport ( 43, 5 ) to ( 43, 10 )
