result path
 Mouse Property 
- energy : 3920 / mana - 5 / Current Steps - 400 / Remaining energy - 3520 / Current Position - ( 0, 31 )
Maze Size 40*49
¡á¡¡¡á¡á¡á¡á¡á¡á¡á¡á¡á¡á¡á¡á¡á¡á¡á¡á¡á¡á¡á¡á¡á¡á¡á¡á¡á¡á¡á¡á¡á¡á¡á¡á¡á¡á¡á¡á¡á£¿
¡á¡¡¡¡¡¡¡¡¡¡¡¡¡¡¡¡¡¡¡¡¡¡¡¡¡¡¡¡¡¡¡¡¡¡¡¡¡¡¡¡¡¡¡¡¡¡¡¡¡¡¡¡¡¡¡¡¡¡¡¡¡¡¡¡¡¡¡¡¡¡¡¡¡¡¡¡¡á
£¿¡á¡á¡á¡á¡¡¡á¡á¡á¡á¡á¡á¡á¡á¡á¡á¡á¡á¡á¡á¡á¡á¡á¡á¡á¡¡¡á¡á¡á¡á¡á¡á¡á¡á¡á¡á¡á¡á¡¡¡á
£¿£¿£¿£¿£¿£¿£¿£¿£¿£¿£¿£¿£¿£¿£¿£¿£¿£¿£¿£¿£¿£¿£¿£¿£¿£¿£¿£¿£¿£¿£¿£¿£¿£¿£¿£¿£¿¡á¡¡¡á
£¿£¿£¿£¿£¿£¿£¿£¿£¿£¿£¿£¿£¿£¿£¿£¿£¿£¿£¿£¿£¿£¿£¿£¿£¿£¿£¿£¿£¿£¿£¿£¿£¿£¿£¿£¿£¿¡á¡¡¡á
£¿£¿£¿£¿£¿£¿£¿£¿£¿£¿£¿£¿£¿£¿£¿£¿£¿£¿£¿£¿£¿£¿£¿£¿£¿£¿£¿£¿£¿£¿£¿£¿£¿£¿£¿£¿£¿¡á¡¡¡á
£¿£¿£¿£¿£¿£¿£¿£¿£¿£¿£¿£¿£¿£¿£¿£¿£¿£¿£¿£¿£¿£¿£¿£¿£¿£¿£¿£¿£¿£¿£¿£¿£¿£¿£¿£¿£¿¡á¡¡¡á
£¿£¿£¿£¿£¿£¿£¿£¿£¿£¿£¿£¿£¿£¿£¿£¿£¿£¿£¿£¿£¿£¿£¿£¿£¿£¿£¿£¿£¿£¿£¿£¿£¿£¿£¿£¿£¿¡á¡¡¡á
£¿£¿£¿£¿£¿£¿£¿£¿£¿£¿£¿£¿£¿£¿£¿£¿£¿£¿£¿£¿£¿£¿£¿£¿£¿£¿£¿£¿£¿£¿£¿£¿£¿£¿£¿£¿£¿¡á¡¡¡á
£¿£¿£¿£¿£¿£¿£¿£¿£¿£¿£¿£¿£¿£¿£¿£¿£¿£¿£¿£¿£¿£¿£¿£¿£¿£¿£¿£¿£¿£¿£¿£¿£¿£¿£¿£¿£¿¡á¡¡¡á
£¿£¿£¿£¿£¿£¿£¿£¿£¿£¿£¿£¿£¿£¿£¿£¿£¿£¿£¿£¿£¿£¿£¿£¿£¿£¿£¿£¿£¿£¿£¿£¿£¿£¿£¿£¿£¿¡á¡¡¡á
£¿£¿£¿£¿£¿£¿£¿£¿£¿£¿£¿£¿£¿£¿£¿£¿£¿£¿£¿£¿£¿£¿£¿£¿£¿£¿£¿£¿£¿£¿£¿£¿£¿£¿£¿£¿£¿¡á¡¡¡á
£¿£¿£¿£¿£¿£¿£¿£¿£¿£¿£¿£¿£¿£¿£¿£¿£¿£¿£¿£¿£¿£¿£¿£¿£¿£¿£¿£¿£¿£¿£¿£¿£¿£¿£¿£¿£¿¡á¡¡¡á
£¿£¿£¿£¿£¿£¿£¿£¿£¿£¿£¿£¿£¿£¿£¿£¿£¿£¿£¿£¿£¿£¿£¿£¿£¿£¿£¿£¿£¿£¿£¿£¿£¿£¿£¿£¿£¿¡á¡¡¡á
£¿£¿£¿£¿£¿£¿£¿£¿£¿£¿£¿£¿£¿£¿£¿£¿£¿£¿£¿£¿£¿£¿£¿£¿£¿£¿£¿£¿£¿£¿£¿£¿£¿£¿£¿£¿£¿¡á¡¡¡á
£¿£¿£¿£¿£¿£¿£¿£¿£¿£¿£¿£¿£¿£¿£¿£¿£¿£¿£¿£¿£¿£¿£¿£¿£¿£¿£¿£¿£¿£¿£¿£¿£¿£¿£¿£¿£¿¡á¡¡¡á
£¿£¿£¿£¿£¿£¿£¿£¿£¿£¿£¿£¿£¿£¿£¿£¿£¿£¿£¿£¿£¿£¿£¿£¿£¿£¿£¿£¿£¿£¿£¿£¿£¿£¿£¿£¿£¿¡á¡¡¡á
£¿¡á¡á¡á¡á¡á¡á¡á¡á¡á¡á¡á¡á¡á¡á¡á¡á¡á¡á¡á¡á¡á¡á¡á¡á¡á¡á¡¡¡á¡á¡á¡á¡á¡á¡á¡á¡á¡á¡¡¡á
¡á¡¡¡¡¡¡¡¡¡¡¡¡¡¡¡¡¡¡¡¡¡¡¡¡¡¡¡¡¡¡¡¡¡¡¡¡¡¡¡¡¡¡¡¡¡¡¡¡¡¡¡¡¡¡¡¡¡¡¡¡¡¡¡¡¡¡¡¡¡¡¡¡¡¡¡¡¡á
¡á¡¡¡á¡á¡á¡¡¡á¡á¡á¡á¡á¡á¡á¡¡¡á¡á¡á¡á¡á¡¡¡á¡á¡á¡á¡á¡á¡¡¡á¡á¡á¡á¡á¡á¡á¡á¡á¡¡¡á¡á£¿
¡á¡¡¡á£¿¡á¡¡¡á¡¡¡¡¡¡¡á£¿¡á¡¡¡á£¿£¿£¿¡á¡¡¡¡¡á£¿£¿£¿¡á¡¡¡á¡á¡á¡á¡á¡á¡á£¿¡á¡¡¡á£¿£¿
¡á¡¡¡á£¿¡á¡¡¡á¡á¡á¡¡¡á£¿¡á¡¡¡á£¿£¿¡á¡¡¡á¡¡¡á£¿£¿£¿¡á¡¡¡¡¡¡¡¡¡¡¡¡¡¡¡¡¡á¡á¡¡¡á£¿£¿
¡á¡¡¡á£¿¡á¡¡¡á£¿¡á¡¡¡á¡á¡á¡¡¡á£¿£¿¡á¡¡¡á¡¡¡á£¿£¿£¿¡á¡¡¡á¡á¡á¡á¡á¡á¡¡¡á¡á¡¡¡á£¿£¿
¡á¡¡¡á£¿¡á¡¡¡á£¿¡á¡¡¡¡¡¡¡á¡¡¡á£¿£¿¡á¡¡¡á¡á£¿£¿£¿¡á¡¡¡¡¡¡¡¡¡¡¡¡¡á¡á¡¡¡á¡á¡¡¡á£¿£¿
¡á¡¡¡á£¿¡á¡¡¡á£¿¡á¡¡¡á¡¡¡á¡¡¡á¡á¡á¡á¡¡¡á£¿£¿¡á£¿£¿¡á¡¡¡á¡á¡á¡á£¿¡á¡¡¡á¡á¡¡¡á£¿£¿
¡á¡¡¡á£¿¡á¡¡¡á¡á¡á¡¡¡á¡¡¡á¡¡¡¡¡¡¡¡¡¡¡¡¡á¡á¡á¡¡¡á¡á¡á¡¡¡á¡¡¡á£¿£¿¡á¡¡¡á¡á¡¡¡á£¿£¿
¡á¡¡¡á£¿¡á¡¡¡¡¡¡¡¡¡¡¡á¡¡¡á¡¡¡á¡á¡á¡á¡á¡á¡¡¡¡¡¡¡¡¡¡¡¡¡¡¡¡¡¡¡á¡á¡á¡á¡¡¡á¡á¡¡¡á£¿£¿
¡á¡¡¡á£¿£¿¡á¡á¡á¡á¡á¡á¡¡¡á¡á¡á¡¡¡á¡á¡¡¡á¡¡¡á¡á¡á¡¡¡á¡á¡á¡á¡á¡¡¡¡¡¡¡¡¡á¡á¡¡¡á£¿£¿
¡á¡¡¡á¡á¡á¡á¡á¡á¡á¡á¡á¡á¡á¡á¡á¡¡¡á¡á¡¡¡á¡á¡á¡á¡á¡á¡á¡á¡á¡á¡á¡á¡á¡á¡á¡á¡á¡¡¡á£¿£¿
¡á¡¡¡á¡¡¡¡¡¡¡¡¡¡¡¡¡¡¡¡¡¡¡¡¡¡¡¡¡¡¡¡¡¡¡¡¡¡¡¡¡¡¡¡¡¡¡¡¡¡¡¡¡¡¡¡¡¡¡¡¡¡¡¡¡¡¡¡¡¡¡¡¡á£¿£¿
¡á¡¡¡á¡á¡á¡á¡á¡á¡á¡á¡¡¡á¡á¡á¡á¡á¡á¡á¡á¡á¡á¡á¡á¡¡¡á¡á¡á¡¡¡á¡á¡á¡á¡á¡á¡á¡á¡¡¡á£¿£¿
¨Ù¡¡¡á£¿£¿£¿£¿£¿£¿¡á¡¡¡á£¿£¿£¿£¿£¿£¿£¿£¿£¿£¿¡á¡¡¡á£¿¡á¡¡¡á£¿£¿£¿£¿£¿£¿¡á¡¡¡á£¿£¿
¡á¡¡£¿£¿£¿£¿£¿£¿£¿£¿¡á£¿£¿£¿£¿£¿£¿£¿£¿£¿£¿£¿¡á¡¡¡á£¿¡á¡¡¡á£¿£¿£¿£¿£¿£¿¡á¡¡¡á£¿£¿
£¿£¿£¿£¿£¿£¿£¿£¿£¿£¿£¿£¿£¿£¿£¿£¿£¿£¿£¿£¿£¿£¿¡á¡¡¡á£¿¡á¡¡¡á£¿£¿£¿£¿£¿£¿¡á¡¡¡á£¿£¿
£¿£¿£¿£¿£¿£¿£¿£¿£¿£¿£¿£¿£¿£¿£¿£¿£¿£¿£¿£¿£¿£¿¡á¡¡¡á¡á¡á¡¡¡á£¿£¿£¿£¿£¿£¿¡á¡¡¡á£¿£¿
£¿£¿£¿£¿£¿£¿£¿£¿£¿£¿£¿£¿£¿£¿£¿£¿£¿£¿£¿£¿£¿£¿¡á¡¡¡¡¡¡¡¡¡á£¿£¿£¿£¿£¿£¿£¿¡á¡¡¡á£¿£¿
£¿£¿£¿£¿£¿£¿£¿£¿£¿£¿£¿£¿£¿£¿£¿£¿£¿£¿£¿£¿£¿£¿£¿¡á¡á¡¡¡á£¿£¿£¿£¿£¿£¿£¿£¿¡á¡¡¡á£¿£¿
£¿£¿£¿£¿£¿£¿£¿£¿£¿£¿£¿£¿£¿£¿£¿£¿£¿£¿£¿£¿£¿£¿£¿£¿£¿¡á£¿£¿£¿£¿£¿£¿£¿£¿£¿¡á¡¡¡á£¿£¿
£¿£¿£¿£¿£¿£¿£¿£¿£¿£¿£¿£¿£¿£¿£¿£¿£¿£¿£¿£¿£¿£¿£¿£¿£¿£¿£¿£¿£¿£¿£¿£¿£¿£¿£¿¡á¡¡¡á£¿£¿
£¿£¿£¿£¿£¿£¿£¿£¿£¿£¿£¿£¿£¿£¿£¿£¿£¿£¿£¿£¿£¿£¿£¿£¿£¿£¿£¿£¿£¿£¿£¿£¿£¿£¿£¿¡á¡¡¡á£¿£¿
£¿£¿£¿£¿£¿£¿£¿£¿£¿£¿£¿£¿£¿£¿£¿£¿£¿£¿£¿£¿£¿£¿£¿£¿£¿£¿£¿£¿£¿£¿£¿£¿£¿£¿£¿¡á¡¡¡á£¿£¿
£¿£¿£¿£¿£¿£¿£¿£¿£¿£¿£¿£¿£¿£¿£¿£¿£¿£¿£¿£¿£¿£¿£¿£¿£¿£¿£¿£¿£¿£¿£¿£¿£¿£¿£¿¡á¡¡¡á£¿£¿
£¿£¿£¿£¿£¿£¿£¿£¿£¿£¿£¿£¿£¿£¿£¿£¿£¿£¿£¿£¿£¿£¿£¿£¿£¿£¿£¿£¿£¿£¿£¿£¿£¿£¿£¿¡á¡¡¡á£¿£¿
£¿£¿£¿£¿£¿£¿£¿£¿£¿£¿£¿£¿£¿£¿£¿£¿£¿£¿£¿£¿£¿£¿£¿£¿£¿£¿£¿£¿£¿£¿£¿£¿£¿£¿¡á¡¡¡¡¡á£¿£¿
£¿£¿£¿£¿£¿£¿£¿£¿£¿£¿£¿£¿£¿£¿£¿£¿£¿£¿£¿£¿£¿£¿£¿£¿£¿£¿£¿£¿£¿£¿£¿£¿£¿£¿£¿¡á¡¡¡á¡á£¿
£¿£¿£¿£¿£¿£¿£¿£¿£¿£¿£¿£¿£¿£¿£¿£¿£¿£¿£¿£¿£¿£¿£¿£¿£¿£¿£¿£¿£¿£¿£¿£¿£¿£¿£¿¡á¡¡¡¡¡¡¡á
£¿£¿£¿£¿£¿£¿£¿£¿£¿£¿£¿£¿£¿£¿£¿£¿£¿£¿£¿£¿£¿£¿£¿£¿£¿£¿£¿£¿£¿£¿£¿£¿£¿£¿£¿£¿¡á¡á¡á£¿
£¿£¿£¿£¿£¿£¿£¿£¿£¿£¿£¿£¿£¿£¿£¿£¿£¿£¿£¿£¿£¿£¿£¿£¿£¿£¿£¿£¿£¿£¿£¿£¿£¿£¿£¿£¿£¿£¿£¿£¿
£¿£¿£¿£¿£¿£¿£¿£¿£¿£¿£¿£¿£¿£¿£¿£¿£¿£¿£¿£¿£¿£¿£¿£¿£¿£¿£¿£¿£¿£¿£¿£¿£¿£¿£¿£¿£¿£¿£¿£¿
Teleport ( 38, 45 ) to ( 36, 43 )
Teleport ( 27, 34 ) to ( 27, 29 )
Teleport ( 3, 29 ) to ( 10, 29 )
Teleport ( 30, 27 ) to ( 26, 21 )
Teleport ( 20, 22 ) to ( 19, 18 )
Teleport ( 18, 21 ) to ( 13, 25 )
Teleport ( 11, 27 ) to ( 9, 23 )
